src tpp not found in walsinfo (dir = data/bible-com/tpp_eng)
src qvm not found in walsinfo (dir = data/bible-com/qvm_eng)
src twi not found in walsinfo (dir = data/bible-com/twi_eng)
src tod not found in walsinfo (dir = data/bible-com/tod_eng)
src ikk not found in walsinfo (dir = data/bible-com/ikk_eng)
src aai not found in walsinfo (dir = data/bible-com/aai_eng)
src zao not found in walsinfo (dir = data/bible-com/zao_eng)
src zho not found in walsinfo (dir = data/bible-com/zho_eng)
src tsw not found in walsinfo (dir = data/bible-com/tsw_eng)
src gqr not found in walsinfo (dir = data/bible-com/gqr_eng)
src ojb not found in walsinfo (dir = data/bible-com/ojb_eng)
src caf not found in walsinfo (dir = data/bible-com/caf_eng)
src acf not found in walsinfo (dir = data/bible-com/acf_eng)
src ebk not found in walsinfo (dir = data/bible-com/ebk_eng)
src qvz not found in walsinfo (dir = data/bible-com/qvz_eng)
src kyg not found in walsinfo (dir = data/bible-com/kyg_eng)
src zpo not found in walsinfo (dir = data/bible-com/zpo_eng)
src hrv not found in walsinfo (dir = data/bible-com/hrv_eng)
src nho not found in walsinfo (dir = data/bible-com/nho_eng)
src msc not found in walsinfo (dir = data/bible-com/msc_eng)
src mfk not found in walsinfo (dir = data/bible-com/mfk_eng)
src dob not found in walsinfo (dir = data/bible-com/dob_eng)
src nng not found in walsinfo (dir = data/bible-com/nng_eng)
src mlg not found in walsinfo (dir = data/bible-com/mlg_eng)
src lmp not found in walsinfo (dir = data/bible-com/lmp_eng)
src mpx not found in walsinfo (dir = data/bible-com/mpx_eng)
src med not found in walsinfo (dir = data/bible-com/med_eng)
src cuk not found in walsinfo (dir = data/bible-com/cuk_eng)
src mti not found in walsinfo (dir = data/bible-com/mti_eng)
src msk not found in walsinfo (dir = data/bible-com/msk_eng)
src kua not found in walsinfo (dir = data/bible-com/kua_eng)
src xtn not found in walsinfo (dir = data/bible-com/xtn_eng)
src klt not found in walsinfo (dir = data/bible-com/klt_eng)
src sny not found in walsinfo (dir = data/bible-com/sny_eng)
src kbm not found in walsinfo (dir = data/bible-com/kbm_eng)
src xtm not found in walsinfo (dir = data/bible-com/xtm_eng)
src aak not found in walsinfo (dir = data/bible-com/aak_eng)
src nca not found in walsinfo (dir = data/bible-com/nca_eng)
src kxw not found in walsinfo (dir = data/bible-com/kxw_eng)
src gdr not found in walsinfo (dir = data/bible-com/gdr_eng)
src epo not found in walsinfo (dir = data/bible-com/epo_eng)
src khs not found in walsinfo (dir = data/bible-com/khs_eng)
src giz not found in walsinfo (dir = data/bible-com/giz_eng)
src zae not found in walsinfo (dir = data/bible-com/zae_eng)
src kwj not found in walsinfo (dir = data/bible-com/kwj_eng)
src lid not found in walsinfo (dir = data/bible-com/lid_eng)
src box not found in walsinfo (dir = data/bible-com/box_eng)
src nph not found in walsinfo (dir = data/bible-com/nph_eng)
src mzz not found in walsinfo (dir = data/bible-com/mzz_eng)
src lgm not found in walsinfo (dir = data/bible-com/lgm_eng)
src zyp not found in walsinfo (dir = data/bible-com/zyp_eng)
src ruf not found in walsinfo (dir = data/bible-com/ruf_eng)
src yal not found in walsinfo (dir = data/bible-com/yal_eng)
src tnn not found in walsinfo (dir = data/bible-com/tnn_eng)
src chz not found in walsinfo (dir = data/bible-com/chz_eng)
src bmh not found in walsinfo (dir = data/bible-com/bmh_eng)
src lsi not found in walsinfo (dir = data/bible-com/lsi_eng)
src big not found in walsinfo (dir = data/bible-com/big_eng)
src quf not found in walsinfo (dir = data/bible-com/quf_eng)
src lai not found in walsinfo (dir = data/bible-com/lai_eng)
src gyr not found in walsinfo (dir = data/bible-com/gyr_eng)
src krj not found in walsinfo (dir = data/bible-com/krj_eng)
src mgc not found in walsinfo (dir = data/bible-com/mgc_eng)
src ots not found in walsinfo (dir = data/bible-com/ots_eng)
src rmc not found in walsinfo (dir = data/bible-com/rmc_eng)
src bbj not found in walsinfo (dir = data/bible-com/bbj_eng)
src pmx not found in walsinfo (dir = data/bible-com/pmx_eng)
src suc not found in walsinfo (dir = data/bible-com/suc_eng)
src hns not found in walsinfo (dir = data/bible-com/hns_eng)
src agw not found in walsinfo (dir = data/bible-com/agw_eng)
src rar not found in walsinfo (dir = data/bible-com/rar_eng)
src xsb not found in walsinfo (dir = data/bible-com/xsb_eng)
src gam not found in walsinfo (dir = data/bible-com/gam_eng)
src leh not found in walsinfo (dir = data/bible-com/leh_eng)
src abx not found in walsinfo (dir = data/bible-com/abx_eng)
src mux not found in walsinfo (dir = data/bible-com/mux_eng)
src suz not found in walsinfo (dir = data/bible-com/suz_eng)
src mse not found in walsinfo (dir = data/bible-com/mse_eng)
src esk not found in walsinfo (dir = data/bible-com/esk_eng)
src taw not found in walsinfo (dir = data/bible-com/taw_eng)
src aso not found in walsinfo (dir = data/bible-com/aso_eng)
src soy not found in walsinfo (dir = data/bible-com/soy_eng)
src bmk not found in walsinfo (dir = data/bible-com/bmk_eng)
src ssg not found in walsinfo (dir = data/bible-com/ssg_eng)
src qul not found in walsinfo (dir = data/bible-com/qul_eng)
src pdc not found in walsinfo (dir = data/bible-com/pdc_eng)
src zsr not found in walsinfo (dir = data/bible-com/zsr_eng)
src atg not found in walsinfo (dir = data/bible-com/atg_eng)
src adl not found in walsinfo (dir = data/bible-com/adl_eng)
src nnh not found in walsinfo (dir = data/bible-com/nnh_eng)
src gnw not found in walsinfo (dir = data/bible-com/gnw_eng)
src pls not found in walsinfo (dir = data/bible-com/pls_eng)
src nif not found in walsinfo (dir = data/bible-com/nif_eng)
src gun not found in walsinfo (dir = data/bible-com/gun_eng)
src nde not found in walsinfo (dir = data/bible-com/nde_eng)
src qwh not found in walsinfo (dir = data/bible-com/qwh_eng)
src mee not found in walsinfo (dir = data/bible-com/mee_eng)
src gnb not found in walsinfo (dir = data/bible-com/gnb_eng)
src tte not found in walsinfo (dir = data/bible-com/tte_eng)
src mmo not found in walsinfo (dir = data/bible-com/mmo_eng)
src maa not found in walsinfo (dir = data/bible-com/maa_eng)
src tgp not found in walsinfo (dir = data/bible-com/tgp_eng)
src udu not found in walsinfo (dir = data/bible-com/udu_eng)
src srp not found in walsinfo (dir = data/bible-com/srp_eng)
src taj not found in walsinfo (dir = data/bible-com/taj_eng)
src yom not found in walsinfo (dir = data/bible-com/yom_eng)
src msa not found in walsinfo (dir = data/bible-com/msa_eng)
src dgr not found in walsinfo (dir = data/bible-com/dgr_eng)
src nmo not found in walsinfo (dir = data/bible-com/nmo_eng)
src imo not found in walsinfo (dir = data/bible-com/imo_eng)
src xnn not found in walsinfo (dir = data/bible-com/xnn_eng)
src qvs not found in walsinfo (dir = data/bible-com/qvs_eng)
src gul not found in walsinfo (dir = data/bible-com/gul_eng)
src xtd not found in walsinfo (dir = data/bible-com/xtd_eng)
src njn not found in walsinfo (dir = data/bible-com/njn_eng)
src mta not found in walsinfo (dir = data/bible-com/mta_eng)
src mmx not found in walsinfo (dir = data/bible-com/mmx_eng)
src heg not found in walsinfo (dir = data/bible-com/heg_eng)
src yby not found in walsinfo (dir = data/bible-com/yby_eng)
src nfa not found in walsinfo (dir = data/bible-com/nfa_eng)
src zpc not found in walsinfo (dir = data/bible-com/zpc_eng)
src atb not found in walsinfo (dir = data/bible-com/atb_eng)
src eza not found in walsinfo (dir = data/bible-com/eza_eng)
src bon not found in walsinfo (dir = data/bible-com/bon_eng)
src kqe not found in walsinfo (dir = data/bible-com/kqe_eng)
src obo not found in walsinfo (dir = data/bible-com/obo_eng)
src kyu not found in walsinfo (dir = data/bible-com/kyu_eng)
src gdn not found in walsinfo (dir = data/bible-com/gdn_eng)
src ify not found in walsinfo (dir = data/bible-com/ify_eng)
src crt not found in walsinfo (dir = data/bible-com/crt_eng)
src ded not found in walsinfo (dir = data/bible-com/ded_eng)
src nbe not found in walsinfo (dir = data/bible-com/nbe_eng)
src ria not found in walsinfo (dir = data/bible-com/ria_eng)
src zam not found in walsinfo (dir = data/bible-com/zam_eng)
src ifa not found in walsinfo (dir = data/bible-com/ifa_eng)
src cot not found in walsinfo (dir = data/bible-com/cot_eng)
src bjv not found in walsinfo (dir = data/bible-com/bjv_eng)
src bbr not found in walsinfo (dir = data/bible-com/bbr_eng)
src tuf not found in walsinfo (dir = data/bible-com/tuf_eng)
src asg not found in walsinfo (dir = data/bible-com/asg_eng)
src ktm not found in walsinfo (dir = data/bible-com/ktm_eng)
src jvn not found in walsinfo (dir = data/bible-com/jvn_eng)
src wiu not found in walsinfo (dir = data/bible-com/wiu_eng)
src boj not found in walsinfo (dir = data/bible-com/boj_eng)
src nch not found in walsinfo (dir = data/bible-com/nch_eng)
src mza not found in walsinfo (dir = data/bible-com/mza_eng)
src zad not found in walsinfo (dir = data/bible-com/zad_eng)
src tku not found in walsinfo (dir = data/bible-com/tku_eng)
src cux not found in walsinfo (dir = data/bible-com/cux_eng)
src ndj not found in walsinfo (dir = data/bible-com/ndj_eng)
src mkn not found in walsinfo (dir = data/bible-com/mkn_eng)
src pfe not found in walsinfo (dir = data/bible-com/pfe_eng)
src eka not found in walsinfo (dir = data/bible-com/eka_eng)
src fai not found in walsinfo (dir = data/bible-com/fai_eng)
src nhd not found in walsinfo (dir = data/bible-com/nhd_eng)
src iws not found in walsinfo (dir = data/bible-com/iws_eng)
src mzl not found in walsinfo (dir = data/bible-com/mzl_eng)
src ksp not found in walsinfo (dir = data/bible-com/ksp_eng)
src nhy not found in walsinfo (dir = data/bible-com/nhy_eng)
src njm not found in walsinfo (dir = data/bible-com/njm_eng)
src bps not found in walsinfo (dir = data/bible-com/bps_eng)
src qxn not found in walsinfo (dir = data/bible-com/qxn_eng)
src bgs not found in walsinfo (dir = data/bible-com/bgs_eng)
src nin not found in walsinfo (dir = data/bible-com/nin_eng)
src myk not found in walsinfo (dir = data/bible-com/myk_eng)
src kgf not found in walsinfo (dir = data/bible-com/kgf_eng)
src zpv not found in walsinfo (dir = data/bible-com/zpv_eng)
src smk not found in walsinfo (dir = data/bible-com/smk_eng)
src due not found in walsinfo (dir = data/bible-com/due_eng)
src nrf not found in walsinfo (dir = data/bible-com/nrf_eng)
src mbh not found in walsinfo (dir = data/bible-com/mbh_eng)
src wat not found in walsinfo (dir = data/bible-com/wat_eng)
src dtp not found in walsinfo (dir = data/bible-com/dtp_eng)
src bdd not found in walsinfo (dir = data/bible-com/bdd_eng)
src qxo not found in walsinfo (dir = data/bible-com/qxo_eng)
src zac not found in walsinfo (dir = data/bible-com/zac_eng)
src soq not found in walsinfo (dir = data/bible-com/soq_eng)
src qxh not found in walsinfo (dir = data/bible-com/qxh_eng)
src pah not found in walsinfo (dir = data/bible-com/pah_eng)
src mck not found in walsinfo (dir = data/bible-com/mck_eng)
src mbd not found in walsinfo (dir = data/bible-com/mbd_eng)
src gkp not found in walsinfo (dir = data/bible-com/gkp_eng)
src yre not found in walsinfo (dir = data/bible-com/yre_eng)
src ata not found in walsinfo (dir = data/bible-com/ata_eng)
src hot not found in walsinfo (dir = data/bible-com/hot_eng)
src kqf not found in walsinfo (dir = data/bible-com/kqf_eng)
src usp not found in walsinfo (dir = data/bible-com/usp_eng)
src zia not found in walsinfo (dir = data/bible-com/zia_eng)
src azg not found in walsinfo (dir = data/bible-com/azg_eng)
src mit not found in walsinfo (dir = data/bible-com/mit_eng)
src bhl not found in walsinfo (dir = data/bible-com/bhl_eng)
src nii not found in walsinfo (dir = data/bible-com/nii_eng)
src pri not found in walsinfo (dir = data/bible-com/pri_eng)
src otn not found in walsinfo (dir = data/bible-com/otn_eng)
src qvw not found in walsinfo (dir = data/bible-com/qvw_eng)
src maj not found in walsinfo (dir = data/bible-com/maj_eng)
src buk not found in walsinfo (dir = data/bible-com/buk_eng)
src txq not found in walsinfo (dir = data/bible-com/txq_eng)
src toc not found in walsinfo (dir = data/bible-com/toc_eng)
src mtp not found in walsinfo (dir = data/bible-com/mtp_eng)
src clu not found in walsinfo (dir = data/bible-com/clu_eng)
src zca not found in walsinfo (dir = data/bible-com/zca_eng)
src hnj not found in walsinfo (dir = data/bible-com/hnj_eng)
src kvj not found in walsinfo (dir = data/bible-com/kvj_eng)
src grc not found in walsinfo (dir = data/bible-com/grc_eng)
src omw not found in walsinfo (dir = data/bible-com/omw_eng)
src rai not found in walsinfo (dir = data/bible-com/rai_eng)
src npo not found in walsinfo (dir = data/bible-com/npo_eng)
src xog not found in walsinfo (dir = data/bible-com/xog_eng)
src fuq not found in walsinfo (dir = data/bible-com/fuq_eng)
src cnl not found in walsinfo (dir = data/bible-com/cnl_eng)
src tbk not found in walsinfo (dir = data/bible-com/tbk_eng)
src bjp not found in walsinfo (dir = data/bible-com/bjp_eng)
src dhm not found in walsinfo (dir = data/bible-com/dhm_eng)
src mcq not found in walsinfo (dir = data/bible-com/mcq_eng)
src gvl not found in walsinfo (dir = data/bible-com/gvl_eng)
src klv not found in walsinfo (dir = data/bible-com/klv_eng)
src cni not found in walsinfo (dir = data/bible-com/cni_eng)
src gud not found in walsinfo (dir = data/bible-com/gud_eng)
src nct not found in walsinfo (dir = data/bible-com/nct_eng)
src kjs not found in walsinfo (dir = data/bible-com/kjs_eng)
src leg not found in walsinfo (dir = data/bible-com/leg_eng)
src kew not found in walsinfo (dir = data/bible-com/kew_eng)
src alb not found in walsinfo (dir = data/bible-com/alb_eng)
src pdt not found in walsinfo (dir = data/bible-com/pdt_eng)
src msm not found in walsinfo (dir = data/bible-com/msm_eng)
src cpb not found in walsinfo (dir = data/bible-com/cpb_eng)
src nsa not found in walsinfo (dir = data/bible-com/nsa_eng)
src cpc not found in walsinfo (dir = data/bible-com/cpc_eng)
src kqs not found in walsinfo (dir = data/bible-com/kqs_eng)
src kpf not found in walsinfo (dir = data/bible-com/kpf_eng)
src zom not found in walsinfo (dir = data/bible-com/zom_eng)
src uvl not found in walsinfo (dir = data/bible-com/uvl_eng)
src whk not found in walsinfo (dir = data/bible-com/whk_eng)
src dik not found in walsinfo (dir = data/bible-com/dik_eng)
src akh not found in walsinfo (dir = data/bible-com/akh_eng)
src gng not found in walsinfo (dir = data/bible-com/gng_eng)
src tuc not found in walsinfo (dir = data/bible-com/tuc_eng)
src khz not found in walsinfo (dir = data/bible-com/khz_eng)
src lbb not found in walsinfo (dir = data/bible-com/lbb_eng)
src mhl not found in walsinfo (dir = data/bible-com/mhl_eng)
src kqw not found in walsinfo (dir = data/bible-com/kqw_eng)
src jac not found in walsinfo (dir = data/bible-com/jac_eng)
src xla not found in walsinfo (dir = data/bible-com/xla_eng)
src rup not found in walsinfo (dir = data/bible-com/rup_eng)
src gdg not found in walsinfo (dir = data/bible-com/gdg_eng)
src kdl not found in walsinfo (dir = data/bible-com/kdl_eng)
src wmw not found in walsinfo (dir = data/bible-com/wmw_eng)
src nss not found in walsinfo (dir = data/bible-com/nss_eng)
src ctu not found in walsinfo (dir = data/bible-com/ctu_eng)
src kdi not found in walsinfo (dir = data/bible-com/kdi_eng)
src anv not found in walsinfo (dir = data/bible-com/anv_eng)
src crm not found in walsinfo (dir = data/bible-com/crm_eng)
src muy not found in walsinfo (dir = data/bible-com/muy_eng)
src sxb not found in walsinfo (dir = data/bible-com/sxb_eng)
src mpg not found in walsinfo (dir = data/bible-com/mpg_eng)
src iqw not found in walsinfo (dir = data/bible-com/iqw_eng)
src awx not found in walsinfo (dir = data/bible-com/awx_eng)
src cut not found in walsinfo (dir = data/bible-com/cut_eng)
src nwx not found in walsinfo (dir = data/bible-com/nwx_eng)
src qve not found in walsinfo (dir = data/bible-com/qve_eng)
src meq not found in walsinfo (dir = data/bible-com/meq_eng)
src khy not found in walsinfo (dir = data/bible-com/khy_eng)
src mpp not found in walsinfo (dir = data/bible-com/mpp_eng)
src dww not found in walsinfo (dir = data/bible-com/dww_eng)
src mir not found in walsinfo (dir = data/bible-com/mir_eng)
src zas not found in walsinfo (dir = data/bible-com/zas_eng)
src bnp not found in walsinfo (dir = data/bible-com/bnp_eng)
src mqb not found in walsinfo (dir = data/bible-com/mqb_eng)
src vmy not found in walsinfo (dir = data/bible-com/vmy_eng)
src pis not found in walsinfo (dir = data/bible-com/pis_eng)
src lat not found in walsinfo (dir = data/bible-com/lat_eng)
src rme not found in walsinfo (dir = data/bible-com/rme_eng)
src dad not found in walsinfo (dir = data/bible-com/dad_eng)
src plw not found in walsinfo (dir = data/bible-com/plw_eng)
src cpu not found in walsinfo (dir = data/bible-com/cpu_eng)
src mbi not found in walsinfo (dir = data/bible-com/mbi_eng)
src nri not found in walsinfo (dir = data/bible-com/nri_eng)
src cpy not found in walsinfo (dir = data/bible-com/cpy_eng)
src kmk not found in walsinfo (dir = data/bible-com/kmk_eng)
src kdc not found in walsinfo (dir = data/bible-com/kdc_eng)
src mbs not found in walsinfo (dir = data/bible-com/mbs_eng)
src zty not found in walsinfo (dir = data/bible-com/zty_eng)
src tpa not found in walsinfo (dir = data/bible-com/tpa_eng)
src tpz not found in walsinfo (dir = data/bible-com/tpz_eng)
src wbm not found in walsinfo (dir = data/bible-com/wbm_eng)
src vid not found in walsinfo (dir = data/bible-com/vid_eng)
src ivb not found in walsinfo (dir = data/bible-com/ivb_eng)
src nxd not found in walsinfo (dir = data/bible-com/nxd_eng)
src ifu not found in walsinfo (dir = data/bible-com/ifu_eng)
src tim not found in walsinfo (dir = data/bible-com/tim_eng)
src nop not found in walsinfo (dir = data/bible-com/nop_eng)
src nhw not found in walsinfo (dir = data/bible-com/nhw_eng)
src sim not found in walsinfo (dir = data/bible-com/sim_eng)
src maz not found in walsinfo (dir = data/bible-com/maz_eng)
src ztq not found in walsinfo (dir = data/bible-com/ztq_eng)
src nvm not found in walsinfo (dir = data/bible-com/nvm_eng)
src atd not found in walsinfo (dir = data/bible-com/atd_eng)
src kze not found in walsinfo (dir = data/bible-com/kze_eng)
src ajz not found in walsinfo (dir = data/bible-com/ajz_eng)
src mxq not found in walsinfo (dir = data/bible-com/mxq_eng)
src gof not found in walsinfo (dir = data/bible-com/gof_eng)
src pps not found in walsinfo (dir = data/bible-com/pps_eng)
src mkl not found in walsinfo (dir = data/bible-com/mkl_eng)
src yut not found in walsinfo (dir = data/bible-com/yut_eng)
src nma not found in walsinfo (dir = data/bible-com/nma_eng)
src hra not found in walsinfo (dir = data/bible-com/hra_eng)
src bss not found in walsinfo (dir = data/bible-com/bss_eng)
src waj not found in walsinfo (dir = data/bible-com/waj_eng)
src zpt not found in walsinfo (dir = data/bible-com/zpt_eng)
src ttq not found in walsinfo (dir = data/bible-com/ttq_eng)
src aby not found in walsinfo (dir = data/bible-com/aby_eng)
src zar not found in walsinfo (dir = data/bible-com/zar_eng)
src ino not found in walsinfo (dir = data/bible-com/ino_eng)
src syb not found in walsinfo (dir = data/bible-com/syb_eng)
src ikw not found in walsinfo (dir = data/bible-com/ikw_eng)
src aeu not found in walsinfo (dir = data/bible-com/aeu_eng)
src cfm not found in walsinfo (dir = data/bible-com/cfm_eng)
src mox not found in walsinfo (dir = data/bible-com/mox_eng)
src npl not found in walsinfo (dir = data/bible-com/npl_eng)
src bqj not found in walsinfo (dir = data/bible-com/bqj_eng)
src iou not found in walsinfo (dir = data/bible-com/iou_eng)
src ngp not found in walsinfo (dir = data/bible-com/ngp_eng)
src pne not found in walsinfo (dir = data/bible-com/pne_eng)
src ayr not found in walsinfo (dir = data/bible-com/ayr_eng)
src ubr not found in walsinfo (dir = data/bible-com/ubr_eng)
src nno not found in walsinfo (dir = data/bible-com/nno_eng)
src tke not found in walsinfo (dir = data/bible-com/tke_eng)
src aim not found in walsinfo (dir = data/bible-com/aim_eng)
src cgc not found in walsinfo (dir = data/bible-com/cgc_eng)
src ksc not found in walsinfo (dir = data/bible-com/ksc_eng)
src biu not found in walsinfo (dir = data/bible-com/biu_eng)
src loq not found in walsinfo (dir = data/bible-com/loq_eng)
src vut not found in walsinfo (dir = data/bible-com/vut_eng)
src agn not found in walsinfo (dir = data/bible-com/agn_eng)
src yim not found in walsinfo (dir = data/bible-com/yim_eng)
src jra not found in walsinfo (dir = data/bible-com/jra_eng)
src kmm not found in walsinfo (dir = data/bible-com/kmm_eng)
src yml not found in walsinfo (dir = data/bible-com/yml_eng)
src prf not found in walsinfo (dir = data/bible-com/prf_eng)
src lmk not found in walsinfo (dir = data/bible-com/lmk_eng)
src wuv not found in walsinfo (dir = data/bible-com/wuv_eng)
src dah not found in walsinfo (dir = data/bible-com/dah_eng)
src qxr not found in walsinfo (dir = data/bible-com/qxr_eng)
src zpl not found in walsinfo (dir = data/bible-com/zpl_eng)
src maf not found in walsinfo (dir = data/bible-com/maf_eng)
src knv not found in walsinfo (dir = data/bible-com/knv_eng)
src zpu not found in walsinfo (dir = data/bible-com/zpu_eng)
src lhi not found in walsinfo (dir = data/bible-com/lhi_eng)
src sgb not found in walsinfo (dir = data/bible-com/sgb_eng)
src cwe not found in walsinfo (dir = data/bible-com/cwe_eng)
src qup not found in walsinfo (dir = data/bible-com/qup_eng)
src kud not found in walsinfo (dir = data/bible-com/kud_eng)
src mxb not found in walsinfo (dir = data/bible-com/mxb_eng)
src kyf not found in walsinfo (dir = data/bible-com/kyf_eng)
src ziw not found in walsinfo (dir = data/bible-com/ziw_eng)
src hne not found in walsinfo (dir = data/bible-com/hne_eng)
src mav not found in walsinfo (dir = data/bible-com/mav_eng)
src sbl not found in walsinfo (dir = data/bible-com/sbl_eng)
src ted not found in walsinfo (dir = data/bible-com/ted_eng)
src nhi not found in walsinfo (dir = data/bible-com/nhi_eng)
src bbb not found in walsinfo (dir = data/bible-com/bbb_eng)
src kkc not found in walsinfo (dir = data/bible-com/kkc_eng)
src kqp not found in walsinfo (dir = data/bible-com/kqp_eng)
src hag not found in walsinfo (dir = data/bible-com/hag_eng)
src aui not found in walsinfo (dir = data/bible-com/aui_eng)
src bch not found in walsinfo (dir = data/bible-com/bch_eng)
src dwr not found in walsinfo (dir = data/bible-com/dwr_eng)
src qub not found in walsinfo (dir = data/bible-com/qub_eng)
src hbo not found in walsinfo (dir = data/bible-com/hbo_eng)
src kix not found in walsinfo (dir = data/bible-com/kix_eng)
src bzh not found in walsinfo (dir = data/bible-com/bzh_eng)
src nnp not found in walsinfo (dir = data/bible-com/nnp_eng)
src msb not found in walsinfo (dir = data/bible-com/msb_eng)
src vap not found in walsinfo (dir = data/bible-com/vap_eng)
src tnp not found in walsinfo (dir = data/bible-com/tnp_eng)
src lbk not found in walsinfo (dir = data/bible-com/lbk_eng)
src icr not found in walsinfo (dir = data/bible-com/icr_eng)
src gaw not found in walsinfo (dir = data/bible-com/gaw_eng)
src kqc not found in walsinfo (dir = data/bible-com/kqc_eng)
src mwm not found in walsinfo (dir = data/bible-com/mwm_eng)
src cac not found in walsinfo (dir = data/bible-com/cac_eng)
src ksr not found in walsinfo (dir = data/bible-com/ksr_eng)
src zat not found in walsinfo (dir = data/bible-com/zat_eng)
src niq not found in walsinfo (dir = data/bible-com/niq_eng)
src nou not found in walsinfo (dir = data/bible-com/nou_eng)
src nhe not found in walsinfo (dir = data/bible-com/nhe_eng)
src att not found in walsinfo (dir = data/bible-com/att_eng)
src ktj not found in walsinfo (dir = data/bible-com/ktj_eng)
src ipi not found in walsinfo (dir = data/bible-com/ipi_eng)
src mlh not found in walsinfo (dir = data/bible-com/mlh_eng)
src aaz not found in walsinfo (dir = data/bible-com/aaz_eng)
src kmu not found in walsinfo (dir = data/bible-com/kmu_eng)
